{
    "info": {
        "name": "Smirk",
        "author": "Noobkin"
    },

    "switches": {

        "14,10": {
            "toggle": [

                { "pos": { "x": 11, "y": 4 } },
                { "pos": { "x": 12, "y": 4 } },
                { "pos": { "x": 13, "y": 4 } },
                { "pos": { "x": 14, "y": 4 } },

                { "pos": { "x": 12, "y": 5 } },
                { "pos": { "x": 13, "y": 5 } },
                { "pos": { "x": 14, "y": 5 } },
                { "pos": { "x": 15, "y": 5 } },

                { "pos": { "x": 13, "y": 6 } },
                { "pos": { "x": 14, "y": 6 } },
                { "pos": { "x": 15, "y": 6 } },
                { "pos": { "x": 16, "y": 6 } },

                { "pos": { "x": 14, "y": 7 } },
                { "pos": { "x": 15, "y": 7 } },
                { "pos": { "x": 16, "y": 7 } },

                { "pos": { "x": 14, "y": 8 } },
                { "pos": { "x": 15, "y": 8 } },
                { "pos": { "x": 16, "y": 8 } }
            ]
        },
        "46,10": {
            "toggle": [

                { "pos": { "x": 49, "y": 4 } },
                { "pos": { "x": 48, "y": 4 } },
                { "pos": { "x": 47, "y": 4 } },
                { "pos": { "x": 46, "y": 4 } },

                { "pos": { "x": 48, "y": 5 } },
                { "pos": { "x": 47, "y": 5 } },
                { "pos": { "x": 46, "y": 5 } },
                { "pos": { "x": 45, "y": 5 } },

                { "pos": { "x": 47, "y": 6 } },
                { "pos": { "x": 46, "y": 6 } },
                { "pos": { "x": 45, "y": 6 } },
                { "pos": { "x": 44, "y": 6 } },

                { "pos": { "x": 46, "y": 7 } },
                { "pos": { "x": 45, "y": 7 } },
                { "pos": { "x": 44, "y": 7 } },

                { "pos": { "x": 46, "y": 8 } },
                { "pos": { "x": 45, "y": 8 } },
                { "pos": { "x": 44, "y": 8 } }
            ]
        }

    },
    "fields": {

    }
}